ajx=AFC_Ajax_Amsterdam
ars=FC_Arsenal
asm=AS_Monaco
atm=Atlético_de_Madrid
bar=FC_Barcelona
bdo=Borussia_Dortmund
ble=Bayer_04_Leverkusen
bmu=FC_Bayern_de_Múnich
che=Chelsea_FC
eve=FC_Everton
int=Inter_de_Milán
juv=Juventus_de_Turín
lei=Leicester_City
lib=Jugadores_Libres
liv=FC_Liverpool
lyo=Olympique_Lyonnais
mci=Manchester_City
mil=AC_Milan
mun=Manchester_United
nap=SSC_Napoli
nic=OGC_Nice
oma=Olympique_de_Marseille
opo=FC_Porto
psg=FC_Paris_Saint-Germain
psv=PSV_Eindhoven
rma=Real_Madrid_CF
rom=AS_Roma
s04=FC_Schalke_04
sev=Sevilla_FC
slb=SL_Benfica
tot=Tottenham_Hotspur
val=Valencia_CF
vil=Villarreal_CF